15 10
0 0 0 
N
00 00 00 00 00 00 09 09 09 00 00 00 00 00 00
00 00 00 00 00 09 21 21 21 09 00 00 00 00 00
00 00 00 00 09 21 21 21 21 21 09 00 00 00 00
00 00 00 09 21 21 21 21 21 21 21 09 00 00 00
00 00 00 09 21 21 21 21 21 21 21 09 00 00 00
00 00 00 09 21 21 21 21 21 21 21 09 00 00 00
00 00 00 09 21 21 21 21 21 21 21 09 00 00 00
00 00 00 00 09 21 21 21 21 21 09 00 00 00 00
00 00 00 00 00 09 21 21 21 09 00 00 00 00 00
00 00 00 00 00 00 09 09 09 00 00 00 00 00 00
0