15 10
0 0 0 
N
09 09 09 09 09 09 09 09 09 09 09 09 09 09 09
09 27 27 27 09 09 27 27 27 09 09 09 09 09 09
09 27 27 27 09 09 00 21 00 09 09 09 09 09 09
09 00 21 00 09 09 09 09 09 09 09 27 27 27 09
09 09 09 09 09 09 09 16 09 09 09 27 27 27 09
09 27 27 27 09 09 16 16 16 09 09 00 21 00 09
09 00 21 00 09 16 16 16 16 16 09 09 09 09 09
09 03 09 03 09 09 16 16 16 09 09 09 09 09 09
09 09 09 09 09 09 09 16 09 09 09 09 09 09 09
09 09 09 09 09 09 09 09 09 09 09 09 09 09 09
0